0000.png
0001.png
0002.png
0003.png
0004.png
0005.png
0006.png
0007.png